False Spring - Shame
Charli xcx - February 2017 (feat. Clairo and Yaeji)
Current Joys - Kids
Nourished by Time - Automatic Love
The Army, The Navy - Bookend
mari park - sustain
Not for Radio - Puddles
Kee'ahn - The Way I Love
Mohammed Assaf - Salam Le Gaza
Le Trio Joubran - The Trees We Wear
Saint Levant/MC Abdul - Deira
Apo &amp; the Apostles - Walhani
Noel Kharman - Haifa
Micah Thomas - Look at the Birds
Branford Marsalis Quartet - Conversation Among the Ruins
Robert Glasper - Afro Blue
The Bad Plus - Casa Ben
Miles Davis - My Funny Valentine (Live at Paris, Salle Pleyel, France - October 1, 1964 [2nd Concert])
John Coltrane - Blue Train
Bug Bus Piano - Voice From Broken Tape
His Name Is Alive - Something About Hope
His Name Is Alive - Coldless
Tetuzi Akiyama - Grandmother's Body
Derek Bailey - Rain Dance Pt 4
Tara Cunningham - Pale, Desire
Supreme Dicks - Untitled
African-American Sound Recordings - moss covered amphitheatre
Storm &amp; Stress - The Sky's the Gound, the Bombs Are Plants, and We're the Sun, Love
Gastr del Sol - At Night And At Night
VOICE ACTOR - Minefields
Aoki Takamasa and Tujiko Noriko - Fly 2
Boards of Canada - In The Annexe
elricfd - nobody here
Hood - When We'll Wait All the Tables
Aerial M - Dazed and Awake
Tedeschi Trucks Band - Layla
Alliance Ethnik - Simple et funky
Iam - Je danse le Mia
MC Solaar - Qui Sème le Vent Récolte le Tempo
De La Soul - The Magic Number
Les Little - Ressens le son
Ménélik - Tout baigne
Passi - Je zappe et je mate
Réciprok - Balance-toi (Radio Version)
Guru - Le Bien, Le Mal
Kheops - Mama Lova
Doc Gyneco - Passement de jambes
Akhénaton - L'Americano
Dub Taylor - Lumière